WWWWWWWWWWWWWWWWWWWWWWWWWWWWWWWWWWWWWWWW
W       X           WWWWWWWWWWWWWWWWWWWW
W                   WWWWWWWWWWWWWWWWWWWW
W                   WWWWWWWWWWWWWWWWWWWW
W                   WWWWWWWWWWWWWWWWWWWW
W                 P WWWWWWWWWWWWWWWWWWWW
W                   WWWWWWWWWWWWWWWWWWWW
W              qqqq WWWWWWWWWWWWWWWWWWWW
W              qqqq WWWWWWWWWWWWWWWWWWWW
W              qqqq WWWWWWWWWWWWWWWWWWWW
Wddddddddddddddqqqq WWWWWWWWWWWWWWWWWWWW
WWWWWWWWWWWWWWWWWWWWWWWWWWWWWWWWWWWWWWWW
WWWWWWWWWWWWWWWWWWWWWWWWWWWWWWWWWWWWWWWW
WWWWWWWWWWWWWWWWWWWWWWWWWWWWWWWWWWWWWWWW
WWWWWWWWWWWWWWWWWWWWWWWWWWWWWWWWWWWWWWWW
WWWWWWWWWWWWWWWWWWWWWWWWWWWWWWWWWWWWWWWW
WWWWWWWWWWWWWWWWWWWWWWWWWWWWWWWWWWWWWWWW
WWWWWWWWWWWWWWWWWWWWWWWWWWWWWWWWWWWWWWWW
WWWWWWWWWWWWWWWWWWWWWWWWWWWWWWWWWWWWWWWW
WWWWWWWWWWWWWWWWWWWWWWWWWWWWWWWWWWWWWWWW
WWWWWWWWWWWWWWWWWWWWWWWWWWWWWWWWWWWWWWWW
WWWWWWWWWWWWWWWWWWWWWWWWWWWWWWWWWWWWWWWW